//MAP CONVERTED BY dmm2tgm.py THIS HEADER COMMENT PREVENTS RECONVERSION, DO NOT REMOVE
"a" = (
/turf/closed/wall/r_wall,
/area/station/command/heads_quarters/nt_rep)
"b" = (
/obj/structure/table/wood/fancy/black,
/obj/item/stamp/denied{
	pixel_x = 6
	},
/obj/item/stamp/solfed{
	pixel_y = 14;
	pixel_x = 6
	},
/obj/item/paper/solfed_rep_guide1{
	pixel_x = -9;
	pixel_y = 10
	},
/obj/item/paper/solfed_rep_guide2{
	pixel_x = -9;
	pixel_y = 5
	},
/obj/item/paper/solfed_rep_guide3{
	pixel_x = -9
	},
/turf/open/floor/carpet/royalblack,
/area/station/command/heads_quarters/nt_rep)
"c" = (
/obj/structure/sign/directions/engineering,
/obj/structure/sign/directions/evac{
	pixel_y = -8
	},
/obj/structure/sign/directions/science{
	pixel_y = 8
	},
/obj/structure/sign/flag/terragov_2,
/turf/closed/wall/r_wall,
/area/station/command/heads_quarters/nt_rep)
"f" = (
/obj/structure/table/wood/fancy/black,
/obj/item/camera_film{
	pixel_x = 6
	},
/obj/item/camera_film{
	pixel_x = 6;
	pixel_y = 4
	},
/obj/item/camera{
	pixel_x = -6;
	pixel_y = 7
	},
/turf/open/floor/mineral/silver,
/turf/open/floor/mineral/silver,
/area/station/command/heads_quarters/nt_rep)
"h" = (
/obj/machinery/light/directional/west,
/turf/template_noop,
/area/template_noop)
"i" = (
/turf/template_noop,
/area/template_noop)
"j" = (
/obj/machinery/light/directional/east,
/obj/machinery/photocopier/prebuilt,
/turf/open/floor/carpet/royalblack,
/area/station/command/heads_quarters/nt_rep)
"k" = (
/obj/effect/landmark/start/nanotrasen_consultant,
/turf/open/floor/carpet/royalblack,
/area/station/command/heads_quarters/nt_rep)
"m" = (
/obj/structure/extinguisher_cabinet/directional/north,
/obj/effect/turf_decal/siding/wood,
/turf/open/floor/wood/tile,
/area/station/command/heads_quarters/nt_rep)
"n" = (
/obj/machinery/atmospherics/pipe/smart/manifold4w/scrubbers/hidden/layer2,
/obj/machinery/atmospherics/components/unary/vent_pump/on/layer4,
/turf/open/floor/wood/tile,
/area/station/command/heads_quarters/nt_rep)
"o" = (
/obj/machinery/button/door/directional/south{
	id = "nt_rep_priv";
	name = "Privacy Shutters Control";
	pixel_x = 8
	},
/obj/item/kirbyplants/random,
/obj/effect/turf_decal/siding/wood/corner{
	dir = 4
	},
/turf/open/floor/wood/tile,
/area/station/command/heads_quarters/nt_rep)
"p" = (
/turf/open/floor/wood/tile,
/area/station/command/heads_quarters/nt_rep)
"q" = (
/obj/structure/chair/office{
	dir = 8
	},
/turf/open/floor/carpet/royalblack,
/area/station/command/heads_quarters/nt_rep)
"s" = (
/obj/machinery/atmospherics/pipe/smart/manifold4w/supply/hidden/layer4,
/obj/machinery/door/airlock/maintenance_hatch{
	name = "Maintenance Hatch"
	},
/obj/effect/turf_decal/stripes/line{
	dir = 1
	},
/obj/effect/turf_decal/stripes/line,
/obj/structure/cable,
/obj/effect/mapping_helpers/airlock/access/all/cent_com/rep_door,
/turf/open/floor/iron,
/area/station/maintenance/port/fore)
"t" = (
/obj/effect/turf_decal/siding/wood,
/obj/machinery/light/directional/west,
/obj/structure/sign/poster/official/random/directional/north,
/obj/item/radio/intercom/directional/west,
/turf/open/floor/wood/tile,
/area/station/command/heads_quarters/nt_rep)
"u" = (
/obj/structure/cable,
/obj/structure/filingcabinet/chestdrawer,
/obj/machinery/power/apc/auto_name/directional/west,
/turf/open/floor/wood/tile,
/area/station/command/heads_quarters/nt_rep)
"v" = (
/obj/machinery/newscaster/directional/west,
/obj/structure/chair/office{
	dir = 4
	},
/obj/effect/landmark/start/nanotrasen_consultant,
/turf/open/floor/carpet/royalblack,
/area/station/command/heads_quarters/nt_rep)
"w" = (
/obj/effect/spawner/structure/window/reinforced,
/obj/machinery/door/poddoor/preopen{
	id = "nt_rep_priv";
	name = "Privacy Shutter"
	},
/obj/structure/plaque/static_plaque/golden{
	name = "NOTICE: Federal Property";
	desc = "This office and all associated fixtures, records, and communications equipment are the property of the Sol Federation federal government. Unauthorized entry, interference, obstruction of duties, damage to property, or any form of hostile action directed toward this office or its occupant is strictly prohibited. This designation is protected under Federal Law. Any violation, attempted or completed, constitutes a Federal criminal offence and will be subject to investigation and prosecution under applicable statutes. All station personnel are required to respect the operational independence and protected status of this office."
	},
/turf/open/floor/plating,
/area/station/command/heads_quarters/nt_rep)
"x" = (
/obj/structure/sign/poster/official/random/directional/south,
/obj/structure/disposalpipe/segment{
	dir = 9
	},
/obj/structure/table/wood/fancy/black,
/obj/item/folder/yellow{
	pixel_x = 4
	},
/obj/item/folder/white,
/obj/item/folder/red{
	pixel_x = -4
	},
/obj/item/folder/blue{
	pixel_x = -8
	},
/obj/item/table_clock{
	pixel_x = -5;
	pixel_y = 16
	},
/turf/open/floor/wood/tile,
/area/station/command/heads_quarters/nt_rep)
"y" = (
/obj/machinery/atmospherics/pipe/smart/manifold4w/supply/hidden/layer4,
/obj/machinery/atmospherics/pipe/smart/manifold4w/scrubbers/hidden/layer2,
/obj/structure/cable,
/turf/open/floor/wood/tile,
/area/station/command/heads_quarters/nt_rep)
"z" = (
/obj/structure/cable,
/obj/effect/turf_decal/siding/wood{
	dir = 4
	},
/obj/machinery/airalarm/directional/north,
/obj/structure/platform/gold,
/obj/structure/statue/silver/nova/large/glow/order{
	pixel_y = 10
	},
/obj/structure/railing{
	dir = 10
	},
/obj/structure/railing{
	dir = 6
	},
/turf/open/floor/wood/tile,
/area/station/command/heads_quarters/nt_rep)
"B" = (
/turf/open/floor/carpet/royalblack,
/area/station/command/heads_quarters/nt_rep)
"C" = (
/obj/machinery/atmospherics/pipe/smart/manifold4w/scrubbers/hidden/layer2,
/obj/effect/turf_decal/siding/wood{
	dir = 8
	},
/obj/structure/cable,
/turf/open/floor/wood/tile,
/area/station/command/heads_quarters/nt_rep)
"D" = (
/obj/structure/closet/secure_closet/nanotrasen_consultant,
/obj/item/storage/briefcase,
/obj/item/assembly/flash/handheld,
/obj/item/clothing/accessory/nova/acc_medal/neckpin/solfed,
/obj/item/clothing/accessory/nova/solfedribbon/rank3,
/obj/item/storage/lunchbox/solfed,
/obj/item/clothing/suit/jacket/tailcoat/lawyer_black,
/obj/item/clothing/suit/toggle/lawyer/black,
/obj/item/clothing/under/rank/civilian/lawyer/black,
/obj/item/clothing/under/rank/civilian/lawyer/black/skirt,
/obj/item/clothing/suit/fedcoat/medsci,
/obj/item/clothing/under/solfed,
/obj/item/encryptionkey/headset_solfed,
/turf/open/floor/mineral/silver,
/turf/open/floor/mineral/silver,
/area/station/command/heads_quarters/nt_rep)
"E" = (
/obj/structure/filingcabinet,
/turf/open/floor/wood/tile,
/area/station/command/heads_quarters/nt_rep)
"F" = (
/obj/machinery/atmospherics/pipe/smart/manifold4w/scrubbers/hidden/layer2,
/obj/effect/turf_decal/siding/wood/corner{
	dir = 8
	},
/obj/structure/cable,
/obj/machinery/holopad,
/turf/open/floor/wood/tile,
/area/station/command/heads_quarters/nt_rep)
"H" = (
/obj/structure/disposalpipe/junction/yjunction{
	dir = 1
	},
/turf/open/floor/iron,
/area/station/hallway/primary/central/fore)
"I" = (
/obj/structure/chair/comfy{
	dir = 1
	},
/obj/effect/landmark/start/nanotrasen_consultant,
/turf/open/floor/carpet/royalblack,
/area/station/command/heads_quarters/nt_rep)
"J" = (
/obj/structure/table/wood/fancy/black,
/obj/item/paper_bin{
	pixel_y = 4
	},
/obj/item/pen/fountain,
/obj/item/deskflag/solfed{
	pixel_y = 6;
	pixel_x = 10
	},
/turf/open/floor/carpet/royalblack,
/area/station/command/heads_quarters/nt_rep)
"K" = (
/obj/machinery/light_switch/directional/north,
/obj/structure/disposalpipe/segment{
	dir = 4
	},
/obj/effect/turf_decal/siding/wood{
	dir = 4
	},
/turf/open/floor/wood/tile,
/area/station/command/heads_quarters/nt_rep)
"L" = (
/obj/machinery/door/airlock/shuttle/ferry{
	name = "Sol Federation Representative's Office"
	},
/obj/structure/disposalpipe/segment{
	dir = 4
	},
/obj/effect/mapping_helpers/airlock/access/all/cent_com/rep_door,
/obj/machinery/door/firedoor,
/obj/machinery/scanner_gate/preset_guns,
/turf/open/floor/iron,
/area/station/command/heads_quarters/nt_rep)
"M" = (
/obj/machinery/status_display/ai/directional/south,
/obj/machinery/modular_computer/preset/command{
	dir = 1
	},
/turf/open/floor/carpet/royalblack,
/area/station/command/heads_quarters/nt_rep)
"P" = (
/obj/machinery/airalarm/directional/south,
/obj/effect/turf_decal/siding/wood{
	dir = 8
	},
/obj/machinery/camera/directional/south{
	c_tag = "NT Consultant's Office";
	name = "command camera"
	},
/obj/structure/cable,
/turf/open/floor/wood/tile,
/area/station/command/heads_quarters/nt_rep)
"Q" = (
/obj/structure/table/wood/fancy/black,
/obj/machinery/fax{
	fax_name = "Sol Federation Representative's Fax Machine"
	},
/turf/open/floor/carpet/royalblack,
/area/station/command/heads_quarters/nt_rep)
"S" = (
/obj/machinery/disposal/bin,
/obj/structure/disposalpipe/trunk{
	dir = 4
	},
/obj/machinery/firealarm/directional/south,
/turf/open/floor/wood/tile,
/area/station/command/heads_quarters/nt_rep)
"T" = (
/obj/structure/sign/flag/terragov,
/turf/closed/wall/r_wall,
/area/station/command/heads_quarters/nt_rep)
"U" = (
/obj/structure/fireplace,
/turf/open/floor/mineral/silver,
/turf/open/floor/mineral/silver,
/area/station/command/heads_quarters/nt_rep)
"V" = (
/obj/machinery/atmospherics/components/unary/vent_scrubber/on/layer2,
/obj/effect/turf_decal/siding/wood/corner{
	dir = 4
	},
/obj/structure/cable,
/obj/effect/landmark/start/nanotrasen_consultant,
/turf/open/floor/wood/tile,
/area/station/command/heads_quarters/nt_rep)
"W" = (
/obj/structure/disposalpipe/segment{
	dir = 6
	},
/turf/open/floor/wood/tile,
/area/station/command/heads_quarters/nt_rep)
"Y" = (
/obj/effect/turf_decal/siding/wood,
/turf/open/floor/wood/tile,
/area/station/command/heads_quarters/nt_rep)

(1,1,1) = {"
i
i
a
a
a
a
a
"}
(2,1,1) = {"
i
i
a
t
v
M
a
"}
(3,1,1) = {"
a
a
a
m
b
J
a
"}
(4,1,1) = {"
a
u
E
Y
q
q
a
"}
(5,1,1) = {"
a
z
V
F
C
P
a
"}
(6,1,1) = {"
a
D
k
B
n
y
s
"}
(7,1,1) = {"
a
U
I
B
p
S
a
"}
(8,1,1) = {"
a
f
Q
j
W
x
a
"}
(9,1,1) = {"
a
a
a
a
K
o
a
"}
(10,1,1) = {"
i
i
i
c
L
w
T
"}
(11,1,1) = {"
i
i
i
i
H
i
h
"}
